6 12
S..#....O..#
...#.#.OO..#
#.OO..#..#.#
#O.O..#B..BG
...#.##.O..#
...#....O..#