6 12
O.....O.O..#
SB...##....#
.#.OOB...#.#
##...O.#..BG
.#...O.#.O.#
..O.#...O.O#