6 12
.#....O...B#
SO..#.OO...#
.O..#...##.#
.O..O......G
.O.O.#...#.#
B....#.#B..#