6 12
S..O.###.#.#
..O.....O..#
..O..#..O..#
##B#.#.#..OG
....B...O..#
....##..O..#