6 12
S#.O...#...#
.#.#.OOB...#
O..#.O.##..#
.O..O...#OOG
..#.O.#.B..#
.#.O...O...#