6 12
SO......#..#
.O..OO..#..#
.#.O.BO.O..#
.#.OB.O.OOOG
.O..OO..#..#
.O......#..#