6 12
S....O.....#
..O..O..O..#
OOB##B##BOO#
..O..O..O..G
..O.....O..#
.....O.....#