6 12
S.O..#...O.#
.#.#.#.B.O.#
.B....O...##
..O##..#...G
.#.#.B.##B##
.#...O.O...#