6 12
S.O....O...#
..OB....O..#
B.##OO.#.O.#
.......#.O.G
..OBO....O.#
..O.....O..#