6 12
S...O..#B#.#
...##...O..#
.O#B.#..O..#
O.#OO.##.B.G
..O..O.....#
.....O.....#