6 12
S..........#
..####.##..#
..#..OBO#..#
..#OBO..#..G
..##.####..#
...........#