6 12
SO.O....O..#
.O.O.OO.O..#
..B.O......#
O...O.OOBOOG
.OO.O..O...#
.....O.O...#