6 12
..#...B#...#
.#.O.#O..#.#
..O#...#..B#
...#...#..OG
.#.O.#O..#.#
S.OB...O...#