6 12
S..........#
.#.O..#..#.#
...B#....#.#
O#OO#O#OO.OG
.#...O#..#.#
.......O...#