6 12
S.#..OBO...#
.......O##.#
#.OO...##..#
.#BO....OOOG
.....O.##..#
..#..B.O...#