6 12
S..O....O.B#
.O..O..O..O#
...BOOO..O.#
.O.OO#...O.G
...O.#.O...#
..O......O.#