6 12
SO..#...OOB#
.#..#...O..#
.#..O...#OO#
.#.B.O....BG
.#..####.#.#
.O..####...#