6 12
S....B.....#
..#####....#
..#B..#.#..#
..##..#O#OOG
....O.#.O..#
....O......#