6 12
S.#...##...#
.B#OO.##...#
..O....O...#
..O....O...G
.B#OO.##...#
..#...##...#