6 12
S..#.......#
...#.OB.#.B#
..O..OOO.OO#
..O........G
...#OO.O...#
...#..BO...#