6 12
S....##.O..#
.#.#.##.#..#
..O.O...O..#
..O.O..BO.BG
.#.#.#..OO##
.....###B..#