6 12
S..........#
..OOO....#.#
..OBO.OOO..#
..OOO.#BO..G
......OOO..#
....#......#