6 12
..O.O..O...#
S.#.O.....B#
.O..#.BO...#
.#.##.#.#..G
.O..O.#.#B##
.#.O#...O..#