6 12
S....O.##..#
...#.O.....#
.#..BOO.#..#
.#..BOO.#..G
...#.O.....#
.....O..#..#