6 12
..#....#...#
S.#.#OO...B#
#.O....###.#
..O..OO.B..G
.#.O...###O#
.#..O..###.#