6 12
S...#.....##
.#B.O...O..#
##.##.#.O.##
..B.....OOBG
.###O.OO..##
.###.......#