6 12
S..O.......#
.#.O.##.O..#
.#O..O..OOO#
.#.#.###B..G
.#.#O.B....#
.O....#.#..#