6 12
S.#.#...#..#
.O.O.O.B.B.#
.O.O.O.....#
..O.O..O.O.G
..O.O..O.O.#
...#....#..#