6 12
S#..##..O..#
.O..#.O..B.#
##.O...#...#
##.O...#.OOG
.O..#.O.B..#
.#..##....##