6 12
S.#..O.....#
..#...O.OOB#
O..O..##...#
.O.O.BB..OOG
..#....O...#
...##..O...#